"","date","County","Total.Tests","Total.Positive.Tests","Total.Recovered","Total.Deaths","Underlying.Cause.Deaths","Contributing.Factor.Deaths","Individuals.Tested","Individuals.Positive","Antigen","Positive.PCR","Positive.Antigen","Active","positivity"
"Adair",2021-02-20,"Adair",10459,904,671,26,20,6,3345,794,552,618,176,97,"0.237369207772795"
"Adams",2021-02-20,"Adams",4402,325,299,3,3,0,1468,317,177,289,28,15,"0.215940054495913"
"Allamakee",2021-02-20,"Allamakee",17568,1431,1273,41,35,6,5582,1387,488,1233,154,73,"0.248477248298101"
"Appanoose",2021-02-20,"Appanoose",15018,1360,1086,47,43,4,5570,1203,746,974,229,70,"0.215978456014363"
"Audubon",2021-02-20,"Audubon",9819,481,413,9,8,1,2416,465,459,396,69,43,"0.192466887417219"
"Benton",2021-02-20,"Benton",30201,2467,2078,54,44,10,11653,2323,1251,2063,260,191,"0.199347807431563"
"Black Hawk",2021-02-20,"Black Hawk",179180,16106,13833,284,267,17,65507,14766,4582,14010,756,649,"0.225411024775978"
"Boone",2021-02-20,"Boone",37243,2559,2205,30,28,2,12729,2383,3193,1739,644,148,"0.187210307172598"
"Bremer",2021-02-20,"Bremer",30869,2750,2449,53,47,6,11280,2629,2530,2039,590,127,"0.233067375886525"
"Buchanan",2021-02-20,"Buchanan",24871,1822,1597,27,24,3,8686,1733,769,1579,154,109,"0.199516463274234"
"Buena Vista",2021-02-20,"Buena Vista",38728,4678,3935,36,33,3,13960,4058,1513,3717,341,87,"0.290687679083095"
"Butler",2021-02-20,"Butler",24285,1654,1488,31,28,3,6557,1570,1634,1133,437,51,"0.239438767729144"
"Calhoun",2021-02-20,"Calhoun",15520,1320,1227,10,10,0,4954,1274,1970,724,550,37,"0.257165926524021"
"Carroll",2021-02-20,"Carroll",30756,2834,2541,47,39,8,10622,2640,2081,2042,598,52,"0.248540764451139"
"Cass",2021-02-20,"Cass",17600,1309,1104,48,45,3,5870,1244,903,1036,208,92,"0.211925042589438"
"Cedar",2021-02-20,"Cedar",25019,1727,1537,22,21,1,8375,1655,767,1549,106,96,"0.197611940298507"
"Cerro Gordo",2021-02-20,"Cerro Gordo",64851,5289,4674,79,67,12,22910,4943,8492,2598,2345,190,"0.215757311217809"
"Cherokee",2021-02-20,"Cherokee",17116,1524,1367,35,29,6,5585,1432,1730,964,468,30,"0.256401074306177"
"Chickasaw",2021-02-20,"Chickasaw",14857,1243,1131,13,12,1,5066,1180,1521,705,475,36,"0.232925384919068"
"Clarke",2021-02-20,"Clarke",11314,979,795,20,20,0,4507,924,1216,646,278,109,"0.205014422010206"
"Clay",2021-02-20,"Clay",24698,1923,1703,25,20,5,7711,1824,1940,1389,435,96,"0.236545195175723"
"Clayton",2021-02-20,"Clayton",20476,1673,1495,53,45,8,6467,1591,664,1397,194,43,"0.24601824648214"
"Clinton",2021-02-20,"Clinton",51076,5349,4517,82,73,9,20543,4920,1155,4617,303,321,"0.239497639098476"
"Crawford",2021-02-20,"Crawford",22787,2696,2313,35,31,4,8236,2475,1115,1877,598,127,"0.300509956289461"
"Dallas",2021-02-20,"Dallas",106040,11110,9024,88,77,11,49631,9919,11369,7566,2353,807,"0.199854929378816"
"Davis",2021-02-20,"Davis",9012,819,687,23,22,1,3135,749,966,511,238,39,"0.238915470494418"
"Decatur",2021-02-20,"Decatur",8390,565,500,9,9,0,3280,550,1927,265,285,41,"0.167682926829268"
"Delaware",2021-02-20,"Delaware",22548,1884,1723,38,33,5,7335,1844,949,1564,280,83,"0.251397409679618"
"Des Moines",2021-02-20,"Des Moines",45951,4500,3907,56,49,7,19607,4193,629,4064,129,230,"0.213852195644413"
"Dickinson",2021-02-20,"Dickinson",21641,2145,1855,38,32,6,9571,1992,795,1799,193,99,"0.20812872218159"
"Dubuque",2021-02-20,"Dubuque",155986,13359,11461,191,178,13,53221,12219,3838,11511,708,567,"0.229589823565886"
"Emmet",2021-02-20,"Emmet",13793,1205,1066,39,37,2,4662,1136,591,1024,112,31,"0.243672243672244"
"Fayette",2021-02-20,"Fayette",28994,1834,1632,32,29,3,8538,1759,1148,1588,171,95,"0.206020145233076"
"Floyd",2021-02-20,"Floyd",21529,1618,1379,38,30,8,7172,1462,1641,1009,453,45,"0.203848298940323"
"Franklin",2021-02-20,"Franklin",17008,1177,1016,19,18,1,4861,1082,2023,554,528,47,"0.222587944867311"
"Fremont",2021-02-20,"Fremont",6264,581,525,9,7,2,2469,549,520,415,134,15,"0.222357229647631"
"Greene",2021-02-20,"Greene",12660,763,692,10,10,0,3825,722,966,466,256,20,"0.188758169934641"
"Grundy",2021-02-20,"Grundy",16039,1367,1204,30,25,5,5378,1297,755,1109,188,63,"0.241167720342135"
"Guthrie",2021-02-20,"Guthrie",14976,1153,1019,28,23,5,5180,1076,1733,669,407,29,"0.207722007722008"
"Hamilton",2021-02-20,"Hamilton",20263,1901,1589,40,39,1,7041,1720,2193,979,741,91,"0.244283482459878"
"Hancock",2021-02-20,"Hancock",17875,1459,1295,28,23,5,5588,1365,1487,855,510,42,"0.244273443092341"
"Hardin",2021-02-20,"Hardin",28502,1781,1548,35,31,4,7736,1661,1912,1172,489,78,"0.21471044467425"
"Harrison",2021-02-20,"Harrison",17288,1776,1520,68,64,4,6030,1653,962,1317,336,65,"0.274129353233831"
"Henry",2021-02-20,"Henry",30685,2917,2654,35,35,0,10214,2777,1996,2049,728,88,"0.271881730957509"
"Howard",2021-02-20,"Howard",13775,1013,839,21,17,4,4182,974,902,722,252,114,"0.232902917264467"
"Humboldt",2021-02-20,"Humboldt",13067,1165,1044,23,20,3,4413,1118,2059,432,686,51,"0.253342397462044"
"Ida",2021-02-20,"Ida",9952,906,728,32,30,2,3035,804,562,627,177,44,"0.264909390444811"
"Iowa",2021-02-20,"Iowa",24586,1425,1262,23,21,2,7513,1365,834,1248,117,80,"0.18168507919606"
"Jackson",2021-02-20,"Jackson",21387,2192,1924,37,34,3,8353,2075,1222,1704,371,114,"0.248413743565186"
"Jasper",2021-02-20,"Jasper",41843,4014,3303,65,61,4,16667,3703,2315,3201,502,335,"0.22217555648887"
"Jefferson",2021-02-20,"Jefferson",17086,1371,1206,32,27,5,7173,1267,613,1103,164,29,"0.176634601979646"
"Johnson",2021-02-20,"Johnson",175355,13655,12196,72,67,5,73315,12925,2977,12456,469,657,"0.17629407351838"
"Jones",2021-02-20,"Jones",21495,2925,2696,54,50,4,9199,2835,710,2614,221,85,"0.308185672355691"
"Keokuk",2021-02-20,"Keokuk",12870,968,845,29,29,0,3853,904,859,645,259,30,"0.234622372177524"
"Kossuth",2021-02-20,"Kossuth",21122,2049,1782,54,47,7,7279,1945,2015,1142,803,109,"0.267207033933233"
"Lee",2021-02-20,"Lee",45002,3705,3216,51,38,13,14734,3493,1244,3170,323,226,"0.237070720781865"
"Linn",2021-02-20,"Linn",241201,20418,17751,305,278,27,107656,19225,14578,16321,2904,1169,"0.178578063461396"
"Louisa",2021-02-20,"Louisa",14606,1265,1127,41,34,7,5053,1207,711,1023,184,39,"0.238867999208391"
"Lucas",2021-02-20,"Lucas",7816,724,648,21,17,4,3514,696,841,505,191,27,"0.198064883323847"
"Lyon",2021-02-20,"Lyon",12543,1444,1345,41,37,4,4277,1440,911,994,446,54,"0.336684592003741"
"Madison",2021-02-20,"Madison",16583,1513,1236,17,13,4,7062,1382,1398,1103,279,129,"0.195695270461626"
"Mahaska",2021-02-20,"Mahaska",25229,2218,1936,44,39,5,9664,2123,2159,1445,678,143,"0.219681291390728"
"Marion",2021-02-20,"Marion",33956,3540,3063,66,58,8,14556,3350,3387,2358,992,221,"0.230145644407804"
"Marshall",2021-02-20,"Marshall",68259,4920,4257,70,63,7,19699,4575,4330,3792,783,248,"0.232245291639169"
"Mills",2021-02-20,"Mills",18677,1612,1368,20,17,3,7204,1462,992,1214,248,74,"0.20294280955025"
"Mitchell",2021-02-20,"Mitchell",14847,1296,1141,40,38,2,5128,1189,711,966,223,8,"0.231864274570983"
"Monona",2021-02-20,"Monona",15197,811,698,25,24,1,3488,758,492,644,114,35,"0.217316513761468"
"Monroe",2021-02-20,"Monroe",8080,915,801,27,21,6,3145,875,379,761,114,47,"0.278219395866455"
"Montgomery",2021-02-20,"Montgomery",11918,1033,863,36,34,2,4134,960,719,761,199,61,"0.2322206095791"
"Muscatine",2021-02-20,"Muscatine",44880,4434,3870,88,79,9,19717,4142,1662,3815,327,184,"0.210072526246386"
"O'Brien",2021-02-20,"O'Brien",21192,1911,1660,58,54,4,6184,1774,1178,1410,364,56,"0.286869340232859"
"Osceola",2021-02-20,"Osceola",6648,690,636,14,12,2,2250,667,344,590,77,17,"0.296444444444444"
"Page",2021-02-20,"Page",16974,1784,1634,19,18,1,5884,1726,996,1314,412,73,"0.293337865397689"
"Palo Alto",2021-02-20,"Palo Alto",15288,1038,911,21,19,2,4168,993,1381,582,411,61,"0.238243761996161"
"Pending Investigation",2021-02-20,"Pending Investigation",13188,915,791,0,0,0,6581,894,2725,525,369,103,"0.135845616167756"
"Plymouth",2021-02-20,"Plymouth",32388,3908,3464,77,69,8,12401,3632,1207,3365,267,91,"0.292879606483348"
"Pocahontas",2021-02-20,"Pocahontas",11159,848,767,19,19,0,3239,804,1156,435,369,18,"0.24822476072862"
"Polk",2021-02-20,"Polk",559726,57064,46417,537,478,59,251806,50635,43571,42264,8371,3681,"0.201087345019579"
"Pottawattamie",2021-02-20,"Pottawattamie",100312,10633,9059,140,125,15,44005,9678,5952,8264,1414,479,"0.219929553459834"
"Poweshiek",2021-02-20,"Poweshiek",33300,1527,1335,29,27,2,8177,1457,1105,1282,175,93,"0.178182707594472"
"Ringgold",2021-02-20,"Ringgold",8345,515,455,16,15,1,2218,496,420,355,141,25,"0.223624887285843"
"Sac",2021-02-20,"Sac",16509,1230,1106,17,17,0,4926,1160,1343,801,359,37,"0.235485180673975"
"Scott",2021-02-20,"Scott",173379,18096,15681,200,187,13,79085,16862,4223,15877,985,981,"0.213213630903458"
"Shelby",2021-02-20,"Shelby",13597,1190,1025,32,29,3,4947,1135,1237,817,318,78,"0.229431978977158"
"Sioux",2021-02-20,"Sioux",36024,4888,4532,67,64,3,14729,4724,1440,4345,379,125,"0.320727815873447"
"Story",2021-02-20,"Story",134854,10035,8776,45,39,6,52374,9378,5977,8379,999,557,"0.179058311375874"
"Tama",2021-02-20,"Tama",27317,2102,1848,64,62,2,7892,1985,1524,1639,346,73,"0.251520527116067"
"Taylor",2021-02-20,"Taylor",7041,660,597,11,9,2,2362,636,300,539,97,28,"0.2692633361558"
"Union",2021-02-20,"Union",14500,1254,1095,31,26,5,6134,1177,527,1039,138,51,"0.191881317248125"
"Van Buren",2021-02-20,"Van Buren",7092,557,489,17,14,3,2542,534,1048,253,281,28,"0.210070810385523"
"Wapello",2021-02-20,"Wapello",38425,4201,3466,105,102,3,16670,3885,2440,3212,673,314,"0.233053389322136"
"Warren",2021-02-20,"Warren",61513,5457,4538,69,64,5,25650,5008,4628,4063,945,401,"0.195243664717349"
"Washington",2021-02-20,"Washington",34429,2530,2196,43,40,3,11016,2377,3413,1558,819,138,"0.215777051561365"
"Wayne",2021-02-20,"Wayne",4923,482,399,21,17,4,2048,445,555,268,177,25,"0.21728515625"
"Webster",2021-02-20,"Webster",58981,5128,4660,85,71,14,20191,4873,9455,1953,2920,128,"0.241345153781388"
"Winnebago",2021-02-20,"Winnebago",14647,1361,1194,30,25,5,5720,1277,1670,793,484,53,"0.223251748251748"
"Winneshiek",2021-02-20,"Winneshiek",29667,1849,1584,26,22,4,9354,1786,832,1656,130,176,"0.190934359632243"
"Woodbury",2021-02-20,"Woodbury",120660,14784,12958,210,194,16,54951,13579,3329,13070,509,411,"0.247111062583029"
"Worth",2021-02-20,"Worth",10544,684,619,4,3,1,3453,650,1115,399,251,27,"0.188242108311613"
"Wright",2021-02-20,"Wright",18320,1780,1650,31,26,5,7491,1717,1202,1316,401,36,"0.229208383393405"
"Total",2021-02-20,"Totals",3946431,358949,308714,5336,4803,533,1536534,332191,235723,276949,55242,18141,"0.216195020741487"
